WIDTH 10
HEIGHT 10
NB_LEMMING 2
TIME_LEMMING 5000
SPAWN_POSITION 3 5
MAP 1 1 1 1 1 1 1 1 1 1 
MAP 1 1 1 1 1 1 1 1 1 1 
MAP 1 1 1 1 1 1 1 1 1 1 
MAP 1 1 1 1 1 1 1 1 1 1 
MAP 1 1 1 1 1 1 1 1 1 1 
MAP 4 1 1 1 1 1 1 1 1 4
MAP 4 4 4 4 4 4 4 4 4 4 
MAP 0 4 4 4 4 4 4 4 4 0 
MAP 0 4 4 4 4 4 4 4 4 0
MAP 0 0 0 0 0 0 0 0 0 0 
