WIDTH 12
HEIGHT 12
NB_LEMMING 1
TIME_LEMMING 5000
SPAWN_POSITION 1 1
MAP 4 4 1 1 1 1 1 1 4 4 4 4 
MAP 4 1 1 1 1 1 1 1 1 4 4 4
MAP 4 4 4 4 4 4 3 4 4 4 4 4
MAP 4 4 4 4 4 3 3 3 4 4 4 4
MAP 1 1 1 1 4 3 3 3 4 1 1 1
MAP 4 4 1 1 1 1 1 1 1 1 4 4
MAP 4 2 1 1 1 1 1 1 1 1 1 4
MAP 4 4 4 3 3 3 3 4 4 4 4 4
MAP 0 0 0 0 0 0 0 0 0 0 0 0
MAP 0 0 0 0 0 0 0 0 0 0 0 0
MAP 0 0 0 0 0 0 0 0 0 0 0 0
MAP 0 0 0 0 0 0 0 0 0 0 0 0
