WIDTH 10
HEIGHT 10
NB_LEMMING 10
TIME_LEMMING 100
MAP 1 1 1 1 1 1 1 1 1 1 
MAP 1 1 1 1 1 1 1 1 1 1 
MAP 1 1 1 1 1 1 1 1 1 1 
MAP 1 1 1 1 1 1 1 1 1 1 
MAP 1 1 1 1 1 1 1 1 1 1 
MAP 1 1 1 1 1 1 1 1 1 1 
MAP 4 4 4 4 4 4 4 4 4 4 
MAP 0 4 4 4 4 4 4 4 4 0 
MAP 0 4 4 4 4 4 4 4 4 0
MAP 0 0 0 0 0 0 0 0 0 0 

